11111111111
100000001E1
10P00C00111
10000010001
11111111111