1111111111111111111111111111111111
10000000000000000C01111111000E0001
1000111111110P00000111111100000001
1000111111110000000000000000000000
1000111111110000000000000000000001
1111111111111111111111111111111111