1111111111111111111111111111111111
1000000000000000000111111100000001
1000111111110000000111111100000001
1000111111110000000000000000000000
1000111111110000000000000000000001
1111111111111111111111111111111111