1111111111111111111111111111111111111
100011P110000000111110000000000000001
1000000000000000111110011110011111001
1001111111110000111110000010010000001
100000000000000000000000C0100100C0001
1000111110000000111110000010010000001
1000111110000000111110011110011111001
10E0111110000000111110000000000000001
1111111111111111111111111111111111111