11111111111111111111111111111
10001000001111111111100010001
10100011101000000000001010101
10111110101111111111101000101
1C000000100000000000001111101
11111110111110111111111C10001
10000010001000000000000000111
10111011101E111111111111101C1
101C1010001110C01111111010101
1P100000100000100000000010001
11111111111111111111111111111